1111111111111111111111111111111111
1111110000000000000000000000000001
10P00000000000000000000000C0000001
1111110000000000000000000000000001
10000C0000000000000000000000000001
1000000000000000000000000000000001
1000000000000000000000000000000001
1111001111111000000000000000000001
100000000C001000000000000000000001
1000000000001000000000000000000001
1111111111111000000000000000000001
1000000000000000000000000000000001
1000000000000000000C00000000000001
1000000000000000000000000000000001
1000000000000000000000010000000001
10000000000000000000000100000C0001
1000000000000000000000001000000001
1000000C00000000000000010000000E01
1000000000000000000000010000000001
1111111111111111111111111111111111
