1111111111
1P00000001
1E00010001
1C00010001
1111111111
