111111111111111111111
1C0000111100000000011
100000011000000001001
1000000010000000010C1
1000000000000000000P1
10C00000111E000000001
111111111111111111111
