111111111111111111
1PE000000000000C01
111111111111111111
