1111111111111111111111111111
1C0000000000P000000000000001
11111110000000000000000000C1
1E00000000000000000000000001
1111111111111111111111111111
