111111111
10P00C001
100E00001
11111 111
