11111111111111
100000E00000C1
11111111111111
