11111111111111
100000E0P000C1
11111111101111