11111100011111
100P00E00000C1
11111111111111
